0,0,0,0,0,0,0,0,0,0,0,0,0,0,0,0,0,0,0,0,0,0,0,0,0,0,0,0,0,0,0,0,
0,0,0,0,0,0,0,0,0,0,0,0,0,0,0,0,0,0,0,0,0,0,0,0,0,0,0,0,0,0,0,0,
0,0,0,0,0,0,0,0,0,0,0,0,0,0,0,0,0,0,0,0,0,0,0,0,0,0,0,0,0,0,0,0,
0,0,0,1,2,3,9,2,3,9,2,3,9,2,3,9,9,3,4,9,3,4,9,3,4,9,3,4,1,0,0,0,
0,0,0,11,12,13,19,12,13,19,12,13,19,12,13,19,19,13,14,19,13,14,19,13,14,19,13,14,11,0,0,0,
0,0,0,21,26,27,22,23,24,25,26,27,22,23,24,25,26,27,22,23,24,25,26,27,22,23,24,25,21,0,0,0,
0,0,0,1,36,37,32,33,34,35,36,37,32,33,34,35,36,37,32,33,34,35,36,37,32,33,34,35,1,0,0,0,
0,0,0,11,26,27,22,23,24,25,26,27,22,23,24,25,26,27,22,23,24,25,26,27,22,23,24,25,11,0,0,0,
0,0,0,21,36,37,32,33,34,35,36,37,32,33,34,35,36,37,32,33,34,35,36,37,32,33,34,35,21,0,0,0,
0,0,0,1,26,27,22,23,24,25,26,27,22,23,24,25,26,27,22,23,24,25,26,27,22,23,24,25,1,0,0,0,
0,0,0,11,36,37,32,33,34,35,36,37,32,33,34,35,36,37,32,33,34,35,36,37,32,33,34,35,11,0,0,0,
9,3,4,38,26,27,22,23,24,25,26,27,22,23,24,25,26,27,22,23,24,25,26,27,22,23,24,25,21,0,0,0,
19,13,14,48,36,37,32,33,34,35,36,37,32,33,34,35,36,37,32,33,34,35,36,37,32,33,34,35,1,0,0,0,
22,23,24,58,26,27,22,23,24,25,26,27,22,23,24,25,26,27,22,23,24,25,26,27,22,23,24,25,11,0,0,0,
32,33,34,35,36,37,32,33,34,35,36,37,32,33,34,35,36,37,32,33,34,35,36,37,32,33,34,35,21,0,0,0,
22,23,24,25,26,27,22,23,24,25,26,27,22,23,24,25,26,27,22,23,24,25,26,27,22,23,24,25,1,0,0,0,
32,33,34,35,36,37,32,33,34,35,36,37,32,33,34,35,36,37,32,33,34,35,36,37,32,33,34,35,11,0,0,0,
10,23,24,1,26,27,22,23,24,25,26,27,22,23,24,25,26,27,22,23,24,25,26,27,22,23,24,25,21,0,0,0,
2,3,4,1,36,37,32,33,34,35,36,37,32,33,34,35,36,37,32,33,34,35,36,37,32,33,34,35,1,0,0,0,
12,13,14,11,26,27,22,23,24,25,26,27,22,23,24,25,26,27,22,23,24,25,26,27,22,23,24,25,11,0,0,0,
0,0,0,1,36,37,32,33,34,35,36,37,32,33,34,35,36,37,32,33,34,35,36,37,32,33,34,35,21,0,0,0,
0,0,0,11,26,27,22,23,24,25,26,27,22,23,24,25,26,27,22,23,24,25,26,27,22,23,24,25,1,0,0,0,
0,0,0,1,36,37,32,33,34,35,36,37,32,33,34,35,36,37,32,33,34,35,36,37,32,33,34,35,11,0,0,0,
0,0,0,11,26,27,22,23,24,25,26,27,22,23,24,25,26,27,22,23,24,25,26,27,22,23,24,25,21,0,0,0,
0,0,0,1,36,37,32,33,34,35,36,37,32,33,34,35,36,37,32,33,34,35,36,37,32,33,34,35,1,0,0,0,
0,0,0,11,26,27,22,23,24,25,26,27,22,23,24,25,26,27,22,23,24,25,26,27,22,23,24,25,11,0,0,0,
0,0,0,1,36,37,10,33,34,10,36,37,10,33,34,35,36,37,32,10,34,35,10,37,32,10,34,35,21,0,0,0,
0,0,0,41,42,43,44,41,42,43,44,41,42,1,44,25,26,27,42,1,41,42,43,44,41,42,43,44,41,0,0,0,
0,0,0,51,52,53,54,51,52,53,54,51,52,11,54,35,36,37,52,11,51,52,53,54,51,52,53,54,51,0,0,0,
0,0,0,0,0,0,0,0,0,0,0,0,0,1,24,25,26,27,22,1,0,0,0,0,0,0,0,0,0,0,0,0,
0,0,0,0,0,0,0,0,0,0,0,0,0,11,34,35,36,37,32,11,0,0,0,0,0,0,0,0,0,0,0,0,
0,0,0,0,0,0,0,0,0,0,0,0,0,21,24,25,26,27,22,21,0,0,0,0,0,0,0,0,0,0,0,0
