0,0,0,0,0,0,0,0,0,0,0,0,0,0,0,0,0,0,0,0,0,0,0,0,0,0,0,0,0,0,0,0,
0,0,0,0,0,0,0,0,0,0,0,0,0,0,0,0,0,0,0,0,0,0,0,0,0,0,0,0,0,0,0,0,
0,0,0,0,0,0,0,0,1,42,43,9,2,2,9,3,4,9,9,2,3,9,2,3,9,2,3,8,0,0,0,0,
0,0,0,0,0,0,0,0,11,52,53,19,12,12,19,13,14,19,19,12,13,19,12,13,19,12,13,18,0,0,0,0,
0,0,0,0,0,0,0,0,1,22,23,24,25,26,27,22,23,24,25,26,27,22,23,24,25,26,27,1,0,0,0,0,
0,0,0,0,0,0,0,0,11,32,33,34,35,36,37,32,33,34,35,36,37,32,33,34,35,36,37,11,0,0,0,0,
0,0,0,0,0,0,0,0,21,22,23,24,25,26,27,22,23,24,25,26,27,22,23,24,25,26,27,21,0,0,0,0,
0,0,0,0,0,0,0,0,31,32,33,34,35,36,37,32,33,34,35,36,37,32,33,34,35,36,37,31,0,0,0,0,
0,0,0,0,0,0,0,0,1,22,23,24,25,26,27,22,23,24,25,26,27,22,23,24,25,26,27,1,0,0,0,0,
0,0,0,0,0,0,0,0,21,35,36,37,32,33,34,35,36,37,32,33,34,35,36,37,32,33,34,28,0,0,0,0,
0,0,0,0,0,0,0,0,31,25,26,27,22,23,24,25,26,27,22,23,24,25,26,27,22,23,24,38,0,0,0,0,
9,42,43,9,41,41,9,43,21,35,36,37,32,33,34,35,36,37,32,33,34,35,36,37,32,33,34,8,0,0,0,0,
19,52,53,19,51,51,19,53,31,25,26,27,22,23,24,25,26,27,22,23,24,25,26,27,22,23,24,18,0,0,0,0,
32,33,34,35,36,37,32,33,41,35,36,37,32,33,34,35,36,37,32,33,34,35,36,37,32,33,34,28,0,0,0,0,
22,23,24,25,26,27,22,23,51,25,26,27,22,23,24,25,26,27,22,23,24,25,26,27,22,23,24,38,0,0,0,0,
32,33,34,35,36,37,32,33,34,35,36,37,32,33,34,35,36,37,32,33,34,35,36,37,32,33,34,8,0,0,0,0,
22,23,24,25,26,27,22,23,24,25,26,27,22,23,24,25,26,27,22,23,24,25,26,27,22,23,24,18,0,0,0,0,
32,33,34,35,36,37,32,33,21,35,36,37,32,33,34,35,36,37,32,33,34,35,36,37,32,33,34,28,0,0,0,0,
10,23,24,10,26,27,10,23,31,25,26,27,22,23,24,25,26,27,22,23,24,25,26,27,22,23,24,38,0,0,0,0,
41,42,43,44,41,41,42,43,1,35,36,37,32,33,34,35,36,37,32,33,34,35,36,37,32,33,34,8,0,0,0,0,
51,52,53,54,51,51,52,53,1,25,26,27,22,23,24,25,26,27,22,23,24,25,26,27,22,23,24,18,0,0,0,0,
0,0,0,0,0,0,0,0,11,35,36,37,32,33,34,35,36,37,32,33,34,35,36,37,32,33,34,28,0,0,0,0,
0,0,0,0,0,0,0,0,21,25,26,27,22,23,24,25,26,27,22,23,24,25,26,27,22,23,24,38,0,0,0,0,
0,0,0,0,0,0,0,0,31,35,36,37,32,33,34,35,36,37,32,33,34,35,36,37,32,33,34,8,0,0,0,0,
0,0,0,0,0,0,0,0,1,25,26,10,22,23,10,25,26,10,10,23,24,10,26,27,10,23,24,18,0,0,0,0,
0,0,0,0,0,0,0,0,2,3,4,2,1,3,4,25,26,3,4,1,41,42,43,44,41,42,43,44,0,0,0,0,
0,0,0,0,0,0,0,0,12,13,14,12,1,13,14,35,36,13,14,11,51,52,53,54,51,52,53,54,0,0,0,0,
0,0,0,0,0,0,0,0,0,0,0,0,1,23,24,25,26,27,22,21,0,0,0,0,0,0,0,0,0,0,0,0,
0,0,0,0,0,0,0,0,0,0,0,0,1,33,34,35,36,37,32,31,0,0,0,0,0,0,0,0,0,0,0,0,
0,0,0,0,0,0,0,0,0,0,0,0,1,23,24,25,26,27,22,1,0,0,0,0,0,0,0,0,0,0,0,0,
0,0,0,0,0,0,0,0,0,0,0,0,1,33,34,35,36,37,32,11,0,0,0,0,0,0,0,0,0,0,0,0,
0,0,0,0,0,0,0,0,0,0,0,0,1,23,24,25,26,27,22,21,0,0,0,0,0,0,0,0,0,0,0,0