0,0,0,0,0,0,0,0,0,0,0,0,0,0,0,0,0,0,0,0,0,0,0,0,0,0,0,0,0,0,0,0,
0,0,0,0,0,0,0,0,0,0,0,0,0,0,0,0,0,0,0,0,0,0,0,0,0,0,0,0,0,0,0,0,
0,0,0,0,0,0,0,0,0,0,0,0,0,0,0,0,0,0,0,0,0,0,0,0,0,0,0,0,0,0,0,0,
0,0,0,1,2,3,9,2,3,9,2,3,9,2,3,9,9,3,4,9,3,4,9,3,4,9,3,4,1,0,0,0,
0,0,0,11,12,13,19,12,13,19,12,13,19,12,13,19,19,13,14,19,13,14,19,13,14,19,13,14,11,0,0,0,
0,0,0,21,22,23,24,25,26,27,22,23,24,25,26,27,22,23,24,25,26,27,22,23,24,25,26,27,21,0,0,0,
0,0,0,31,32,33,34,35,36,37,32,33,34,35,36,37,32,33,34,35,36,37,32,33,34,35,36,37,31,0,0,0,
0,0,0,1,22,23,24,25,26,27,22,23,24,25,26,27,22,23,24,25,26,27,22,23,24,25,26,27,1,0,0,0,
0,0,0,11,32,33,34,35,36,37,32,33,34,35,36,37,32,33,34,35,36,37,32,33,34,35,36,37,11,0,0,0,
0,0,0,21,22,23,24,25,26,27,22,23,24,25,26,27,22,23,24,25,26,27,22,23,24,25,26,27,21,0,0,0,
0,0,0,31,32,33,34,35,36,37,32,33,34,35,36,37,32,33,34,35,36,37,32,33,34,35,36,37,31,0,0,0,
0,0,0,1,22,23,24,25,26,27,22,23,24,25,26,27,22,23,24,25,26,27,22,23,24,25,26,27,1,2,3,9,
0,0,0,11,32,33,34,35,36,37,32,33,34,35,36,37,32,33,34,35,36,37,32,33,34,35,36,37,48,12,13,19,
0,0,0,21,22,23,24,25,26,27,22,23,24,25,26,27,22,23,24,25,26,27,22,23,24,25,26,27,58,23,24,25,
0,0,0,31,32,33,34,35,36,37,32,33,34,35,36,37,32,33,34,35,36,37,32,33,34,35,36,37,32,33,34,35,
0,0,0,1,22,23,24,25,26,27,22,23,24,25,26,27,22,23,24,25,26,27,22,23,24,25,26,27,22,23,24,25,
0,0,0,11,32,33,34,35,36,37,32,33,34,35,36,37,32,33,34,35,36,37,32,33,34,35,36,37,32,33,34,35,
0,0,0,21,22,23,24,25,26,27,22,23,24,25,26,27,22,23,24,25,26,27,22,23,24,25,26,27,1,23,24,10,
0,0,0,31,32,33,34,35,36,37,32,33,34,35,36,37,32,33,34,35,36,37,32,33,34,35,36,37,11,2,3,4,
0,0,0,1,22,23,24,25,26,27,22,23,24,25,26,27,22,23,24,25,26,27,22,23,24,25,26,27,21,12,13,14,
0,0,0,11,32,33,34,35,36,37,32,33,34,35,36,37,32,33,34,35,36,37,32,33,34,35,36,37,31,0,0,0,
0,0,0,21,22,23,24,25,26,27,22,23,24,25,26,27,22,23,24,25,26,27,22,23,24,25,26,27,1,0,0,0,
0,0,0,31,32,33,34,35,36,37,32,33,34,35,36,37,32,33,34,35,36,37,32,33,34,35,36,37,11,0,0,0,
0,0,0,1,22,23,24,25,26,27,22,23,24,25,26,27,22,23,24,25,26,27,22,23,24,25,26,27,21,0,0,0,
0,0,0,11,32,33,34,35,36,37,32,33,34,35,36,37,32,33,34,35,36,37,32,33,34,35,36,37,31,0,0,0,
0,0,0,21,22,23,24,25,26,27,22,23,24,25,26,27,22,23,24,25,26,27,22,23,24,25,26,27,1,0,0,0,
0,0,0,31,32,33,10,35,36,10,32,33,10,35,36,37,32,33,34,10,36,37,10,33,34,10,36,37,11,0,0,0,
0,0,0,2,3,4,2,3,4,2,3,4,2,1,2,27,22,23,2,1,2,3,4,2,3,4,2,3,4,0,0,0,
0,0,0,12,13,14,12,13,14,12,13,14,12,1,12,37,32,33,12,1,12,13,14,12,13,14,12,13,14,0,0,0,
0,0,0,0,0,0,0,0,0,0,0,0,0,1,26,27,22,23,24,1,0,0,0,0,0,0,0,0,0,0,0,0,
0,0,0,0,0,0,0,0,0,0,0,0,0,11,36,37,32,33,34,11,0,0,0,0,0,0,0,0,0,0,0,0,
0,0,0,0,0,0,0,0,0,0,0,0,0,21,26,27,22,23,24,1,0,0,0,0,0,0,0,0,0,0,0,0