0,0,0,0,0,0,0,0,0,0,0,0,0,0,0,0,0,0,0,0,0,0,0,0,0,0,0,0,0,0,0,0,
0,0,0,0,0,0,0,0,0,0,0,0,0,0,0,0,0,0,0,0,0,0,0,0,0,0,0,0,0,0,0,0,
0,0,0,0,0,0,0,0,0,0,0,0,0,0,0,0,0,0,0,0,0,0,0,0,0,0,0,0,0,0,0,0,
0,0,0,1,3,4,9,3,4,9,3,4,9,3,9,9,3,9,2,3,9,2,3,1,0,0,0,0,0,0,0,0,
0,0,0,1,13,14,19,13,14,19,13,14,19,13,19,19,13,19,12,13,19,12,13,11,0,0,0,0,0,0,0,0,
0,0,0,11,22,23,24,25,26,27,22,23,24,25,26,27,22,23,24,25,26,27,22,21,0,0,0,0,0,0,0,0,
0,0,0,21,32,33,34,35,36,37,32,33,34,35,36,37,32,33,34,35,36,37,32,31,0,0,0,0,0,0,0,0,
0,0,0,31,22,23,24,25,26,27,22,23,24,25,26,27,22,23,24,25,26,27,22,31,0,0,0,0,0,0,0,0,
0,0,0,1,32,33,34,35,36,37,32,33,34,35,36,37,32,33,34,35,36,37,32,11,0,0,0,0,0,0,0,0,
0,0,0,11,22,23,24,25,26,27,22,23,24,25,26,27,22,23,24,25,26,27,22,21,0,0,0,0,0,0,0,0,
0,0,0,21,32,33,34,35,36,37,32,33,34,35,36,37,32,33,34,35,36,37,32,31,0,0,0,0,0,0,0,0,
0,0,0,31,22,23,24,25,26,27,22,23,24,25,26,27,22,23,24,25,26,27,22,1,42,9,44,44,9,42,43,9,
0,0,0,1,32,33,34,35,36,37,32,33,34,35,36,37,32,33,34,35,36,37,32,1,52,19,54,54,19,52,53,19,
0,0,0,11,22,23,24,25,26,27,22,23,24,25,26,27,22,23,24,25,26,27,22,41,24,25,26,27,22,23,24,25,
0,0,0,21,32,33,34,35,36,37,32,33,34,35,36,37,32,33,34,35,36,37,32,51,34,35,36,37,32,33,34,35,
0,0,0,31,22,23,24,25,26,27,22,23,24,25,26,27,22,23,24,25,26,27,22,23,24,25,26,27,22,23,24,25,
0,0,0,1,32,33,34,35,36,37,32,33,34,35,36,37,32,33,34,35,36,37,32,33,34,35,36,37,32,33,34,35,
0,0,0,11,22,23,24,25,26,27,22,23,24,25,26,27,22,23,24,25,26,27,22,1,24,25,26,27,22,23,24,25,
0,0,0,21,32,33,34,35,36,37,32,33,34,35,36,37,32,33,34,35,36,37,32,11,34,35,36,37,32,33,34,35,
0,0,0,31,22,23,24,25,26,27,22,23,24,25,26,27,22,23,24,25,26,27,22,1,42,43,44,44,41,42,43,44,
0,0,0,1,32,33,34,35,36,37,32,33,34,35,36,37,32,33,34,35,36,37,32,11,52,53,54,54,51,52,53,54,
0,0,0,11,22,23,24,25,26,27,22,23,24,25,26,27,22,23,24,25,26,27,22,21,0,0,0,0,0,0,0,0,
0,0,0,21,32,33,10,35,36,10,32,33,10,35,10,37,32,10,34,35,10,37,32,31,0,0,0,0,0,0,0,0,
0,0,0,41,42,43,44,44,41,42,43,44,1,3,4,27,22,3,4,1,2,3,4,41,0,0,0,0,0,0,0,0,
0,0,0,51,52,53,54,54,51,52,53,54,11,13,14,37,32,13,14,11,12,13,14,51,0,0,0,0,0,0,0,0,
0,0,0,0,0,0,0,0,0,0,0,0,21,25,26,27,22,23,24,21,0,0,0,0,0,0,0,0,0,0,0,0,
0,0,0,0,0,0,0,0,0,0,0,0,31,35,36,37,32,33,34,31,0,0,0,0,0,0,0,0,0,0,0,0,
0,0,0,0,0,0,0,0,0,0,0,0,31,25,26,27,22,23,24,31,0,0,0,0,0,0,0,0,0,0,0,0,
0,0,0,0,0,0,0,0,0,0,0,0,1,35,36,37,32,33,34,1,0,0,0,0,0,0,0,0,0,0,0,0,
0,0,0,0,0,0,0,0,0,0,0,0,11,25,26,27,22,23,24,11,0,0,0,0,0,0,0,0,0,0,0,0,
0,0,0,0,0,0,0,0,0,0,0,0,21,35,36,37,32,33,34,21,0,0,0,0,0,0,0,0,0,0,0,0,
0,0,0,0,0,0,0,0,0,0,0,0,31,25,26,27,22,23,24,31,0,0,0,0,0,0,0,0,0,0,0,0
