0,0,0,0,0,0,0,0,0,0,0,0,0,1,24,25,26,27,22,1,0,0,0,0,0,0,0,0,0,0,0,0,
0,0,0,0,0,0,0,0,0,0,0,0,0,11,34,35,36,37,32,11,0,0,0,0,0,0,0,0,0,0,0,0,
0,0,0,0,0,0,0,0,0,0,0,0,0,21,24,25,26,27,22,1,0,0,0,0,0,0,0,0,0,0,0,0,
0,0,0,1,41,42,9,44,41,9,43,44,9,42,43,35,36,37,41,9,43,44,9,42,43,9,41,42,1,0,0,0,
0,0,0,11,51,52,19,54,51,19,53,54,19,52,53,25,26,27,51,19,53,54,19,52,53,19,51,52,11,0,0,0,
0,0,0,21,36,37,32,33,34,35,36,37,32,33,34,35,36,37,32,33,34,35,36,37,32,33,34,35,21,0,0,0,
0,0,0,1,26,27,22,23,24,25,26,27,22,23,24,25,26,27,22,23,24,25,26,27,22,23,24,25,1,0,0,0,
0,0,0,11,36,37,32,33,34,35,36,37,32,33,34,35,36,37,32,33,34,35,36,37,32,33,34,35,11,0,0,0,
0,0,0,21,26,27,22,23,24,25,26,27,22,23,24,25,26,27,22,23,24,25,26,27,22,23,24,25,21,0,0,0,
0,0,0,1,36,37,32,33,34,35,36,37,32,33,34,35,36,37,32,33,34,35,36,37,32,33,34,35,1,0,0,0,
0,0,0,11,26,27,22,23,24,25,26,27,22,23,24,25,26,27,22,23,24,25,26,27,22,23,24,25,11,0,0,0,
9,41,42,38,36,37,32,33,34,35,36,37,32,33,34,35,36,37,32,33,34,35,36,37,32,33,34,35,21,0,0,0,
19,51,52,48,26,27,22,23,24,25,26,27,22,23,24,25,26,27,22,23,24,25,26,27,22,23,24,25,1,0,0,0,
32,33,34,58,36,37,32,33,34,35,36,37,32,33,34,35,36,37,32,33,34,35,36,37,32,33,34,35,11,0,0,0,
22,23,24,25,26,27,22,23,24,25,26,27,22,23,24,25,26,27,22,23,24,25,26,27,22,23,24,25,21,0,0,0,
32,33,34,35,36,37,32,33,34,35,36,37,32,33,34,35,36,37,32,33,34,35,36,37,32,33,34,35,1,0,0,0,
22,23,24,25,26,27,22,23,24,25,26,27,22,23,24,25,26,27,22,23,24,25,26,27,22,23,24,25,11,0,0,0,
10,33,34,1,36,37,32,33,34,35,36,37,32,33,34,35,36,37,32,33,34,35,36,37,32,33,34,35,21,0,0,0,
41,42,43,1,26,27,22,23,24,25,26,27,22,23,24,25,26,27,22,23,24,25,26,27,22,23,24,25,1,0,0,0,
51,52,53,11,36,37,32,33,34,35,36,37,32,33,34,35,36,37,32,33,34,35,36,37,32,33,34,35,11,0,0,0,
0,0,0,21,26,27,22,23,24,25,26,27,22,23,24,25,26,27,22,23,24,25,26,27,22,23,24,25,21,0,0,0,
0,0,0,1,36,37,32,33,34,35,36,37,32,33,34,35,36,37,32,33,34,35,36,37,32,33,34,35,1,0,0,0,
0,0,0,11,26,27,22,23,24,25,26,27,22,23,24,25,26,27,22,23,24,25,26,27,22,23,24,25,11,0,0,0,
0,0,0,21,36,37,32,33,34,35,36,37,32,33,34,35,36,37,32,33,34,35,36,37,32,33,34,35,21,0,0,0,
0,0,0,1,26,27,22,23,24,25,26,27,22,23,24,25,26,27,22,23,24,25,26,27,22,23,24,25,1,0,0,0,
0,0,0,11,36,37,32,33,34,35,36,37,32,33,34,35,36,37,32,33,34,35,36,37,32,33,34,35,11,0,0,0,
0,0,0,21,26,27,10,23,24,10,26,27,10,23,24,10,10,27,22,10,24,25,10,27,22,10,24,25,21,0,0,0,
0,0,0,41,42,43,44,41,42,43,44,41,42,43,44,41,42,43,44,41,42,43,44,41,42,43,44,41,42,0,0,0,
0,0,0,51,52,53,54,51,52,53,54,51,52,53,54,51,52,53,54,51,52,53,54,51,52,53,54,51,52,0,0,0,
0,0,0,0,0,0,0,0,0,0,0,0,0,0,0,0,0,0,0,0,0,0,0,0,0,0,0,0,0,0,0,0,
0,0,0,0,0,0,0,0,0,0,0,0,0,0,0,0,0,0,0,0,0,0,0,0,0,0,0,0,0,0,0,0,
0,0,0,0,0,0,0,0,0,0,0,0,0,0,0,0,0,0,0,0,0,0,0,0,0,0,0,0,0,0,0,0
