0,0,0,0,0,0,0,0,0,0,0,0,1,22,23,24,25,26,27,11,0,0,0,0,0,0,0,0,0,0,0,0,
0,0,0,0,0,0,0,0,0,0,0,0,11,32,33,34,35,36,37,21,0,0,0,0,0,0,0,0,0,0,0,0,
0,0,0,0,0,0,0,0,0,0,0,0,21,22,23,24,25,26,27,31,0,0,0,0,0,0,0,0,0,0,0,0,
0,0,0,0,0,0,0,0,0,0,0,0,31,32,33,34,35,36,37,1,0,0,0,0,0,0,0,0,0,0,0,0,
0,0,0,0,0,0,0,0,0,0,0,0,1,22,23,24,25,26,27,11,0,0,0,0,0,0,0,0,0,0,0,0,
0,0,0,0,0,0,0,0,0,0,0,0,11,32,33,34,35,36,37,21,0,0,0,0,0,0,0,0,0,0,0,0,
0,0,0,0,0,0,0,0,0,0,0,0,21,22,23,24,25,26,27,31,0,0,0,0,0,0,0,0,0,0,0,0,
0,0,0,0,0,0,0,0,8,42,43,9,41,41,9,34,35,9,9,41,41,9,43,41,9,41,42,11,0,0,0,0,
0,0,0,0,0,0,0,0,18,52,53,19,51,51,19,24,25,19,19,51,51,19,53,51,19,51,52,21,0,0,0,0,
0,0,0,0,0,0,0,0,28,25,26,27,22,23,24,25,26,27,22,23,24,25,26,27,22,23,24,31,0,0,0,0,
0,0,0,0,0,0,0,0,31,35,36,37,32,33,34,35,36,37,32,33,34,35,36,37,32,33,34,31,0,0,0,0,
9,42,43,9,41,41,9,43,28,25,26,27,22,23,24,25,26,27,22,23,24,25,26,27,22,23,24,8,0,0,0,0,
19,52,53,19,51,51,19,53,28,35,36,37,32,33,34,35,36,37,32,33,34,35,36,37,32,33,34,18,0,0,0,0,
22,23,24,25,26,27,22,23,48,25,26,27,22,23,24,25,26,27,22,23,24,25,26,27,22,23,24,28,0,0,0,0,
32,33,34,35,36,37,32,33,58,35,36,37,32,33,34,35,36,37,32,33,34,35,36,37,32,33,34,38,0,0,0,0,
22,23,24,25,26,27,22,23,24,25,26,27,22,23,24,25,26,27,22,23,24,25,26,27,22,23,24,8,0,0,0,0,
32,33,34,35,36,37,32,33,34,35,36,37,32,33,34,35,36,37,32,33,34,35,36,37,32,33,34,18,0,0,0,0,
22,23,24,25,26,27,22,23,28,25,26,27,22,23,24,25,26,27,22,23,24,25,26,27,22,23,24,28,0,0,0,0,
10,33,34,10,36,37,32,33,38,35,36,37,32,33,34,35,36,37,32,33,34,35,36,37,32,33,34,38,0,0,0,0,
41,42,43,44,41,41,42,43,1,25,26,27,22,23,24,25,26,27,22,23,24,25,26,27,22,23,24,8,0,0,0,0,
51,52,53,54,51,51,52,53,11,35,36,37,32,33,34,35,36,37,32,33,34,35,36,37,32,33,34,18,0,0,0,0,
0,0,0,0,0,0,0,0,21,25,26,27,22,23,24,25,26,27,22,23,24,25,26,27,22,23,24,28,0,0,0,0,
0,0,0,0,0,0,0,0,31,35,36,37,32,33,34,35,36,37,32,33,34,35,36,37,32,33,34,38,0,0,0,0,
0,0,0,0,0,0,0,0,1,25,26,27,22,23,24,25,26,27,22,23,24,25,26,27,22,23,24,8,0,0,0,0,
0,0,0,0,0,0,0,0,11,35,36,37,32,33,34,35,36,37,32,33,34,35,36,37,32,33,34,18,0,0,0,0,
0,0,0,0,0,0,0,0,21,25,26,27,22,23,24,25,26,27,22,23,24,25,26,27,22,23,24,28,0,0,0,0,
0,0,0,0,0,0,0,0,31,35,36,37,32,33,34,35,36,37,32,33,34,35,36,37,32,33,34,38,0,0,0,0,
0,0,0,0,0,0,0,0,1,25,26,10,22,23,10,25,26,10,10,23,24,10,26,27,10,23,24,8,0,0,0,0,
0,0,0,0,0,0,0,0,2,3,4,2,3,4,2,3,4,2,3,4,2,3,4,2,3,4,2,3,0,0,0,0,
0,0,0,0,0,0,0,0,12,13,14,12,13,14,12,13,14,12,13,14,12,13,14,12,13,14,12,13,0,0,0,0,
0,0,0,0,0,0,0,0,0,0,0,0,0,0,0,0,0,0,0,0,0,0,0,0,0,0,0,0,0,0,0,0,
0,0,0,0,0,0,0,0,0,0,0,0,0,0,0,0,0,0,0,0,0,0,0,0,0,0,0,0,0,0,0,0