0,0,0,0,0,0,0,0,0,0,0,0,1,25,26,27,22,23,24,1,0,0,0,0,0,0,0,0,0,0,0,0,
0,0,0,0,0,0,0,0,0,0,0,0,11,35,36,37,32,33,34,11,0,0,0,0,0,0,0,0,0,0,0,0,
0,0,0,0,0,0,0,0,0,0,0,0,21,25,26,27,22,23,24,21,0,0,0,0,0,0,0,0,0,0,0,0,
0,0,0,0,0,0,0,0,0,0,0,0,31,35,36,37,32,33,34,31,0,0,0,0,0,0,0,0,0,0,0,0,
0,0,0,0,0,0,0,0,0,0,0,0,1,25,26,27,22,23,24,1,0,0,0,0,0,0,0,0,0,0,0,0,
0,0,0,0,0,0,0,0,0,0,0,0,1,35,36,37,32,33,34,1,0,0,0,0,0,0,0,0,0,0,0,0,
0,0,0,0,0,0,0,0,0,0,0,0,11,25,26,27,22,23,24,11,0,0,0,0,0,0,0,0,0,0,0,0,
0,0,0,1,41,42,9,44,41,9,43,44,9,2,3,37,32,9,3,2,9,2,3,8,0,0,0,0,0,0,0,0,
0,0,0,11,51,52,19,54,51,19,53,54,19,12,13,27,22,19,13,12,19,12,13,8,0,0,0,0,0,0,0,0,
0,0,0,21,32,33,34,35,36,37,32,33,34,35,36,37,32,33,34,35,36,37,32,18,0,0,0,0,0,0,0,0,
0,0,0,31,22,23,24,25,26,27,22,23,24,25,26,27,22,23,24,25,26,27,22,28,0,0,0,0,0,0,0,0,
0,0,0,1,32,33,34,35,36,37,32,33,34,35,36,37,32,33,34,35,36,37,32,1,3,9,2,3,9,2,3,9,
0,0,0,11,22,23,24,25,26,27,22,23,24,25,26,27,22,23,24,25,26,27,22,11,13,19,12,13,19,12,13,19,
0,0,0,21,32,33,34,35,36,37,32,33,34,35,36,37,32,33,34,35,36,37,32,4,34,35,36,37,32,33,34,35,
0,0,0,31,22,23,24,25,26,27,22,23,24,25,26,27,22,23,24,25,26,27,22,14,24,25,26,27,22,23,24,25,
0,0,0,1,32,33,34,35,36,37,32,33,34,35,36,37,32,33,34,35,36,37,32,33,34,35,36,37,32,33,34,35,
0,0,0,11,22,23,24,25,26,27,22,23,24,25,26,27,22,23,24,25,26,27,22,23,24,25,26,27,22,23,24,25,
0,0,0,21,32,33,34,35,36,37,32,33,34,35,36,37,32,33,34,35,36,37,32,1,34,35,36,37,32,33,34,35,
0,0,0,31,22,23,24,25,26,27,22,23,24,25,26,27,22,23,24,25,26,27,22,11,24,10,26,27,10,23,24,10,
0,0,0,1,32,33,34,35,36,37,32,33,34,35,36,37,32,33,34,35,36,37,32,8,3,4,2,3,4,2,3,4,
0,0,0,11,22,23,24,25,26,27,22,23,24,25,26,27,22,23,24,25,26,27,22,18,13,14,12,13,14,12,13,14,
0,0,0,21,32,33,34,35,36,37,32,33,34,35,36,37,32,33,34,35,36,37,32,28,0,0,0,0,0,0,0,0,
0,0,0,31,22,23,24,25,26,27,22,23,24,25,26,27,22,23,24,25,26,27,22,8,0,0,0,0,0,0,0,0,
0,0,0,1,32,33,34,35,36,37,32,33,34,35,36,37,32,33,34,35,36,37,32,18,0,0,0,0,0,0,0,0,
0,0,0,11,22,23,24,25,26,27,22,23,24,25,26,27,22,23,24,25,26,27,22,28,0,0,0,0,0,0,0,0,
0,0,0,21,32,33,34,35,36,37,32,33,34,35,36,37,32,33,34,35,36,37,32,8,0,0,0,0,0,0,0,0,
0,0,0,31,22,23,10,25,26,10,22,23,10,25,10,10,22,10,24,25,10,27,22,18,0,0,0,0,0,0,0,0,
0,0,0,41,42,43,44,41,42,43,44,41,42,43,44,41,42,43,44,41,42,43,44,41,0,0,0,0,0,0,0,0,
0,0,0,51,52,53,54,51,52,53,54,51,52,53,54,51,52,53,54,51,52,53,54,51,0,0,0,0,0,0,0,0,
0,0,0,0,0,0,0,0,0,0,0,0,0,0,0,0,0,0,0,0,0,0,0,0,0,0,0,0,0,0,0,0,
0,0,0,0,0,0,0,0,0,0,0,0,0,0,0,0,0,0,0,0,0,0,0,0,0,0,0,0,0,0,0,0,
0,0,0,0,0,0,0,0,0,0,0,0,0,0,0,0,0,0,0,0,0,0,0,0,0,0,0,0,0,0,0,0
