0,0,0,0,0,0,0,0,0,0,0,0,0,1,26,27,22,23,24,1,0,0,0,0,0,0,0,0,0,0,0,0,
0,0,0,0,0,0,0,0,0,0,0,0,0,11,36,37,32,33,34,11,0,0,0,0,0,0,0,0,0,0,0,0,
0,0,0,0,0,0,0,0,0,0,0,0,0,21,26,27,22,23,24,21,0,0,0,0,0,0,0,0,0,0,0,0,
0,0,0,1,41,42,9,44,41,9,43,44,9,42,43,37,32,33,41,9,43,44,9,42,43,9,41,42,1,0,0,0,
0,0,0,11,51,52,19,54,51,19,53,54,19,52,53,27,22,23,51,19,53,54,19,52,53,19,51,52,11,0,0,0,
0,0,0,21,32,33,34,35,36,37,32,33,34,35,36,37,32,33,34,35,36,37,32,33,34,35,36,37,21,0,0,0,
0,0,0,31,22,23,24,25,26,27,22,23,24,25,26,27,22,23,24,25,26,27,22,23,24,25,26,27,31,0,0,0,
0,0,0,1,32,33,34,35,36,37,32,33,34,35,36,37,32,33,34,35,36,37,32,33,34,35,36,37,1,0,0,0,
0,0,0,11,22,23,24,25,26,27,22,23,24,25,26,27,22,23,24,25,26,27,22,23,24,25,26,27,11,0,0,0,
0,0,0,21,32,33,34,35,36,37,32,33,34,35,36,37,32,33,34,35,36,37,32,33,34,35,36,37,21,0,0,0,
0,0,0,31,22,23,24,25,26,27,22,23,24,25,26,27,22,23,24,25,26,27,22,23,24,25,26,27,31,0,0,0,
0,0,0,1,32,33,34,35,36,37,32,33,34,35,36,37,32,33,34,35,36,37,32,33,34,35,36,37,1,41,42,9,
0,0,0,11,22,23,24,25,26,27,22,23,24,25,26,27,22,23,24,25,26,27,22,23,24,25,26,27,41,51,52,19,
0,0,0,21,32,33,34,35,36,37,32,33,34,35,36,37,32,33,34,35,36,37,32,33,34,35,36,37,51,33,34,35,
0,0,0,31,22,23,24,25,26,27,22,23,24,25,26,27,22,23,24,25,26,27,22,23,24,25,26,27,22,23,24,25,
0,0,0,1,32,33,34,35,36,37,32,33,34,35,36,37,32,33,34,35,36,37,32,33,34,35,36,37,32,33,34,35,
0,0,0,11,22,23,24,25,26,27,22,23,24,25,26,27,22,23,24,25,26,27,22,23,24,25,26,27,22,23,24,25,
0,0,0,21,32,33,34,35,36,37,32,33,34,35,36,37,32,33,34,35,36,37,32,33,34,35,36,37,1,33,34,10,
0,0,0,31,22,23,24,25,26,27,22,23,24,25,26,27,22,23,24,25,26,27,22,23,24,25,26,27,1,41,42,43,
0,0,0,1,32,33,34,35,36,37,32,33,34,35,36,37,32,33,34,35,36,37,32,33,34,35,36,37,1,51,52,53,
0,0,0,11,22,23,24,25,26,27,22,23,24,25,26,27,22,23,24,25,26,27,22,23,24,25,26,27,11,0,0,0,
0,0,0,21,32,33,34,35,36,37,32,33,34,35,36,37,32,33,34,35,36,37,32,33,34,35,36,37,21,0,0,0,
0,0,0,31,22,23,24,25,26,27,22,23,24,25,26,27,22,23,24,25,26,27,22,23,24,25,26,27,31,0,0,0,
0,0,0,1,32,33,34,35,36,37,32,33,34,35,36,37,32,33,34,35,36,37,32,33,34,35,36,37,1,0,0,0,
0,0,0,11,22,23,24,25,26,27,22,23,24,25,26,27,22,23,24,25,26,27,22,23,24,25,26,27,11,0,0,0,
0,0,0,21,32,33,34,35,36,37,32,33,34,35,36,37,32,33,34,35,36,37,32,33,34,35,36,37,21,0,0,0,
0,0,0,31,22,23,10,25,26,10,22,23,10,25,26,10,10,23,24,10,26,27,10,23,24,10,26,27,31,0,0,0,
0,0,0,41,42,43,44,41,42,43,44,41,42,43,44,41,42,43,44,41,42,43,44,41,42,43,44,41,42,0,0,0,
0,0,0,51,52,53,54,51,52,53,54,51,52,53,54,51,52,53,54,51,52,53,54,51,52,53,54,51,52,0,0,0,
0,0,0,0,0,0,0,0,0,0,0,0,0,0,0,0,0,0,0,0,0,0,0,0,0,0,0,0,0,0,0,0,
0,0,0,0,0,0,0,0,0,0,0,0,0,0,0,0,0,0,0,0,0,0,0,0,0,0,0,0,0,0,0,0,
0,0,0,0,0,0,0,0,0,0,0,0,0,0,0,0,0,0,0,0,0,0,0,0,0,0,0,0,0,0,0,0
