0,0,0,0,0,0,0,0,0,0,0,0,0,0,0,0,0,0,0,0,0,0,0,0,0,0,0,0,0,0,0,0,
0,0,0,0,0,0,0,0,0,0,0,0,0,0,0,0,0,0,0,0,0,0,0,0,0,0,0,0,0,0,0,0,
0,0,0,0,0,0,0,0,0,0,0,0,0,0,0,0,0,0,0,0,0,0,0,0,0,0,0,0,0,0,0,0,
0,0,0,0,0,0,0,0,1,2,3,9,2,3,9,2,3,9,9,3,4,9,3,4,9,3,4,8,0,0,0,0,
0,0,0,0,0,0,0,0,11,12,13,19,12,13,19,12,13,19,19,13,14,19,13,14,19,13,14,18,0,0,0,0,
0,0,0,0,0,0,0,0,21,25,26,27,22,23,24,25,26,27,22,23,24,25,26,27,22,23,24,28,0,0,0,0,
0,0,0,0,0,0,0,0,31,35,36,37,32,33,34,35,36,37,32,33,34,35,36,37,32,33,34,38,0,0,0,0,
0,0,0,0,0,0,0,0,1,25,26,27,22,23,24,25,26,27,22,23,24,25,26,27,22,23,24,8,0,0,0,0,
0,0,0,0,0,0,0,0,11,35,36,37,32,33,34,35,36,37,32,33,34,35,36,37,32,33,34,18,0,0,0,0,
0,0,0,0,0,0,0,0,21,25,26,27,22,23,24,25,26,27,22,23,24,25,26,27,22,23,24,28,0,0,0,0,
0,0,0,0,0,0,0,0,31,35,36,37,32,33,34,35,36,37,32,33,34,35,36,37,32,33,34,38,0,0,0,0,
9,3,4,9,3,4,9,3,8,25,26,27,22,23,24,25,26,27,22,23,24,25,26,27,22,23,24,8,0,0,0,0,
19,13,14,19,13,14,19,13,8,35,36,37,32,33,34,35,36,37,32,33,34,35,36,37,32,33,34,18,0,0,0,0,
22,23,24,25,26,27,22,23,47,25,26,27,22,23,24,25,26,27,22,23,24,25,26,27,22,23,24,28,0,0,0,0,
32,33,34,35,36,37,32,33,57,35,36,37,32,33,34,35,36,37,32,33,34,35,36,37,32,33,34,38,0,0,0,0,
22,23,24,25,26,27,22,23,24,25,26,27,22,23,24,25,26,27,22,23,24,25,26,27,22,23,24,8,0,0,0,0,
32,33,34,35,36,37,32,33,34,35,36,37,32,33,34,35,36,37,32,33,34,35,36,37,32,33,34,18,0,0,0,0,
22,23,24,25,26,27,22,23,8,25,26,27,22,23,24,25,26,27,22,23,24,25,26,27,22,23,24,28,0,0,0,0,
10,33,34,10,36,37,10,33,18,35,36,37,32,33,34,35,36,37,32,33,34,35,36,37,32,33,34,38,0,0,0,0,
2,3,4,2,3,4,2,3,1,25,26,27,22,23,24,25,26,27,22,23,24,25,26,27,22,23,24,8,0,0,0,0,
12,13,14,12,13,14,12,13,11,35,36,37,32,33,34,35,36,37,32,33,34,35,36,37,32,33,34,18,0,0,0,0,
0,0,0,0,0,0,0,0,21,25,26,27,22,23,24,25,26,27,22,23,24,25,26,27,22,23,24,28,0,0,0,0,
0,0,0,0,0,0,0,0,31,35,36,37,32,33,34,35,36,37,32,33,34,35,36,37,32,33,34,38,0,0,0,0,
0,0,0,0,0,0,0,0,1,25,26,27,22,23,24,25,26,27,22,23,24,25,26,27,22,23,24,8,0,0,0,0,
0,0,0,0,0,0,0,0,11,35,36,37,32,33,34,35,36,37,32,33,34,35,36,37,32,33,34,18,0,0,0,0,
0,0,0,0,0,0,0,0,1,25,26,27,22,23,24,25,26,27,22,23,24,25,26,27,22,23,24,28,0,0,0,0,
0,0,0,0,0,0,0,0,11,35,36,10,32,33,10,35,36,10,10,33,34,10,36,37,10,33,34,38,0,0,0,0,
0,0,0,0,0,0,0,0,2,3,4,2,3,4,2,3,4,2,3,4,2,3,4,2,3,4,2,3,0,0,0,0,
0,0,0,0,0,0,0,0,12,13,14,12,13,14,12,13,14,12,13,14,12,13,14,12,13,14,12,13,0,0,0,0,
0,0,0,0,0,0,0,0,0,0,0,0,0,0,0,0,0,0,0,0,0,0,0,0,0,0,0,0,0,0,0,0,
0,0,0,0,0,0,0,0,0,0,0,0,0,0,0,0,0,0,0,0,0,0,0,0,0,0,0,0,0,0,0,0,
0,0,0,0,0,0,0,0,0,0,0,0,0,0,0,0,0,0,0,0,0,0,0,0,0,0,0,0,0,0,0,0
