0,0,0,0,0,0,0,0,0,0,0,0,0,0,0,0,0,0,0,0,0,0,0,0,0,0,0,0,0,0,0,0,
0,0,0,0,0,0,0,0,0,0,0,0,0,0,0,0,0,0,0,0,0,0,0,0,0,0,0,0,0,0,0,0,
0,0,0,0,0,0,0,0,0,0,0,0,0,0,0,0,0,0,0,0,0,0,0,0,0,0,0,0,0,0,0,0,
0,0,0,0,1,3,4,9,4,3,9,4,4,9,9,3,4,9,4,3,9,3,4,8,0,0,0,0,0,0,0,0,
0,0,0,0,11,13,14,19,14,13,19,14,14,19,19,13,14,19,14,13,19,13,14,18,0,0,0,0,0,0,0,0,
0,0,0,0,21,22,23,24,25,26,27,22,23,24,25,26,27,22,23,24,25,26,27,28,0,0,0,0,0,0,0,0,
0,0,0,0,31,32,33,34,35,36,37,32,33,34,35,36,37,32,33,34,35,36,37,38,0,0,0,0,0,0,0,0,
0,0,0,0,1,22,23,24,25,26,27,22,23,24,25,26,27,22,23,24,25,26,27,8,0,0,0,0,0,0,0,0,
0,0,0,0,11,32,33,34,35,36,37,32,33,34,35,36,37,32,33,34,35,36,37,18,0,0,0,0,0,0,0,0,
0,0,0,0,21,22,23,24,25,26,27,22,23,24,25,26,27,22,23,24,25,26,27,28,0,0,0,0,0,0,0,0,
0,0,0,0,31,32,33,34,35,36,37,32,33,34,35,36,37,32,33,34,35,36,37,38,0,0,0,0,0,0,0,0,
0,0,0,0,1,22,23,24,25,26,27,22,23,24,25,26,27,22,23,24,25,26,27,8,3,9,2,3,9,2,3,9,
0,0,0,0,11,32,33,34,35,36,37,32,33,34,35,36,37,32,33,34,35,36,37,28,13,19,12,13,19,12,13,19,
0,0,0,0,21,22,23,24,25,26,27,22,23,24,25,26,27,22,23,24,25,26,27,48,23,24,25,26,27,22,23,24,
0,0,0,0,31,32,33,34,35,36,37,32,33,34,35,36,37,32,33,34,35,36,37,58,33,34,35,36,37,32,33,34,
0,0,0,0,1,22,23,24,25,26,27,22,23,24,25,26,27,22,23,24,25,26,27,22,23,24,25,26,27,22,23,24,
0,0,0,0,11,32,33,34,35,36,37,32,33,34,35,36,37,32,33,34,35,36,37,32,33,34,35,36,37,32,33,34,
0,0,0,0,21,22,23,24,25,26,27,22,23,24,25,26,27,22,23,24,25,26,27,28,23,24,25,26,27,22,23,24,
0,0,0,0,31,32,33,34,35,36,37,32,33,34,35,36,37,32,33,34,35,36,37,38,33,10,35,36,10,32,33,10,
0,0,0,0,1,22,23,24,25,26,27,22,23,24,25,26,27,22,23,24,25,26,27,8,3,20,2,3,20,2,3,20,
0,0,0,0,11,32,33,34,35,36,37,32,33,34,35,36,37,32,33,34,35,36,37,18,13,14,12,13,14,12,13,14,
0,0,0,0,21,22,23,24,25,26,27,22,23,24,25,26,27,22,23,24,25,26,27,28,0,0,0,0,0,0,0,0,
0,0,0,0,31,32,33,34,35,36,37,32,33,34,35,36,37,32,33,34,35,36,37,38,0,0,0,0,0,0,0,0,
0,0,0,0,1,22,23,24,25,26,27,22,23,24,25,26,27,22,23,24,25,26,27,8,0,0,0,0,0,0,0,0,
0,0,0,0,11,32,33,34,35,36,37,32,33,34,35,36,37,32,33,34,35,36,37,18,0,0,0,0,0,0,0,0,
0,0,0,0,21,22,23,24,25,26,27,22,23,24,25,26,27,22,23,24,25,26,27,28,0,0,0,0,0,0,0,0,
0,0,0,0,31,32,33,10,35,36,10,32,33,10,10,36,37,10,33,34,10,36,37,38,0,0,0,0,0,0,0,0,
0,0,0,0,41,42,43,20,41,42,20,44,41,20,20,44,41,20,43,44,20,42,43,44,0,0,0,0,0,0,0,0,
0,0,0,0,51,52,53,54,51,52,53,54,51,52,53,54,51,52,53,54,51,52,53,54,0,0,0,0,0,0,0,0,
0,0,0,0,0,0,0,0,0,0,0,0,0,0,0,0,0,0,0,0,0,0,0,0,0,0,0,0,0,0,0,0,
0,0,0,0,0,0,0,0,0,0,0,0,0,0,0,0,0,0,0,0,0,0,0,0,0,0,0,0,0,0,0,0,
0,0,0,0,0,0,0,0,0,0,0,0,0,0,0,0,0,0,0,0,0,0,0,0,0,0,0,0,0,0,0,0
