0,0,0,0,0,0,0,0,0,0,0,0,1,25,26,27,22,23,24,1,0,0,0,0,0,0,0,0,0,0,0,0,
0,0,0,0,0,0,0,0,0,0,0,0,11,35,36,37,32,33,34,11,0,0,0,0,0,0,0,0,0,0,0,0,
0,0,0,0,0,0,0,0,0,0,0,0,21,25,26,27,22,23,24,21,0,0,0,0,0,0,0,0,0,0,0,0,
0,0,0,0,0,0,0,0,0,0,0,0,31,35,36,37,32,33,34,31,0,0,0,0,0,0,0,0,0,0,0,0,
0,0,0,0,0,0,0,0,0,0,0,0,1,25,26,27,22,23,24,1,0,0,0,0,0,0,0,0,0,0,0,0,
0,0,0,0,0,0,0,0,0,0,0,0,1,35,36,37,32,33,34,1,0,0,0,0,0,0,0,0,0,0,0,0,
0,0,0,0,0,0,0,0,0,0,0,0,11,25,26,27,22,23,24,11,0,0,0,0,0,0,0,0,0,0,0,0,
0,0,0,0,0,0,0,0,0,0,0,0,21,35,36,37,32,33,34,21,0,0,0,0,0,0,0,0,0,0,0,0,
0,0,0,1,2,2,9,2,2,9,2,2,9,3,4,27,22,2,3,9,2,2,9,2,2,9,2,2,1,0,0,0,
0,0,0,11,12,12,19,12,12,19,12,12,19,13,14,37,32,12,13,19,12,12,19,12,12,19,12,12,11,0,0,0,
0,0,0,21,22,23,24,25,26,27,22,23,24,25,26,27,22,23,24,25,26,27,22,23,24,25,26,27,21,0,0,0,
0,0,0,31,32,33,34,35,36,37,32,33,34,35,36,37,32,33,34,35,36,37,32,33,34,35,36,37,31,0,0,0,
0,0,0,1,22,23,24,25,26,27,22,23,24,25,26,27,22,23,24,25,26,27,22,23,24,25,26,27,1,0,0,0,
0,0,0,11,32,33,34,35,36,37,32,33,34,35,36,37,32,33,34,35,36,37,32,33,34,35,36,37,11,0,0,0,
0,0,0,21,22,23,24,25,26,27,22,23,24,25,26,27,22,23,24,25,26,27,22,23,24,25,26,27,21,0,0,0,
0,0,0,31,32,33,34,35,36,37,32,33,34,35,36,37,32,33,34,35,36,37,32,33,34,35,36,37,31,0,0,0,
0,0,0,1,22,23,24,25,26,27,22,23,24,25,26,27,22,23,24,25,26,27,22,23,24,25,26,27,1,0,0,0,
0,0,0,11,32,33,34,35,36,37,32,33,34,35,36,37,32,33,34,35,36,37,32,33,34,35,36,37,11,0,0,0,
0,0,0,21,22,23,24,25,26,27,22,23,24,25,26,27,22,23,24,25,26,27,22,23,24,25,26,27,21,0,0,0,
0,0,0,31,32,33,34,35,36,37,32,33,34,35,36,37,32,33,34,35,36,37,32,33,34,35,36,37,31,0,0,0,
0,0,0,1,22,23,24,25,26,27,22,23,24,25,26,27,22,23,24,25,26,27,22,23,24,25,26,27,1,0,0,0,
0,0,0,11,32,33,34,35,36,37,32,33,34,35,36,37,32,33,34,35,36,37,32,33,34,35,36,37,11,0,0,0,
0,0,0,21,22,23,24,25,26,27,22,23,24,25,26,27,22,23,24,25,26,27,22,23,24,25,26,27,21,0,0,0,
0,0,0,31,32,33,34,35,36,37,32,33,34,35,36,37,32,33,34,35,36,37,32,33,34,35,36,37,31,0,0,0,
0,0,0,1,22,23,24,25,26,27,22,23,24,25,26,27,22,23,24,25,26,27,22,23,24,25,26,27,1,0,0,0,
0,0,0,11,32,22,34,35,36,22,32,33,22,35,36,22,22,33,34,22,36,37,22,33,22,22,36,37,11,0,0,0,
0,0,0,11,32,10,34,35,36,10,32,33,10,35,36,10,10,33,34,10,36,37,10,33,34,10,36,37,11,0,0,0,
0,0,0,2,3,4,2,3,4,2,3,4,2,3,4,2,3,4,2,3,4,2,3,4,2,3,4,2,3,0,0,0,
0,0,0,12,13,14,12,13,14,12,13,14,12,13,14,12,13,14,12,13,14,12,13,14,12,13,14,12,13,0,0,0,
0,0,0,0,0,0,0,0,0,0,0,0,0,0,0,0,0,0,0,0,0,0,0,0,0,0,0,0,0,0,0,0,
0,0,0,0,0,0,0,0,0,0,0,0,0,0,0,0,0,0,0,0,0,0,0,0,0,0,0,0,0,0,0,0,
0,0,0,0,0,0,0,0,0,0,0,0,0,0,0,0,0,0,0,0,0,0,0,0,0,0,0,0,0,0,0,0