0,0,0,0,0,0,0,0,0,0,0,0,0,0,0,0,0,0,0,0,0,0,0,0,0,0,0,0,0,0,0,0,
0,0,0,0,0,0,0,0,0,0,0,0,0,0,0,0,0,0,0,0,0,0,0,0,0,0,0,0,0,0,0,0,
0,0,0,0,0,0,0,0,1,41,42,9,44,41,9,43,44,9,42,43,9,41,42,1,0,0,0,0,0,0,0,0,
0,0,0,0,0,0,0,0,11,51,52,19,54,51,19,53,54,19,52,53,19,51,52,11,0,0,0,0,0,0,0,0,
0,0,0,0,0,0,0,0,21,25,26,27,22,23,24,25,26,27,22,23,24,25,26,21,0,0,0,0,0,0,0,0,
0,0,0,0,0,0,0,0,31,35,36,37,32,33,34,35,36,37,32,33,34,35,36,31,0,0,0,0,0,0,0,0,
0,0,0,0,0,0,0,0,1,25,26,27,22,23,24,25,26,27,22,23,24,25,26,1,0,0,0,0,0,0,0,0,
0,0,0,0,0,0,0,0,11,35,36,37,32,33,34,35,36,37,32,33,34,35,36,11,0,0,0,0,0,0,0,0,
0,0,0,0,0,0,0,0,21,25,26,27,22,23,24,25,26,27,22,23,24,25,26,21,0,0,0,0,0,0,0,0,
0,0,0,0,0,0,0,0,31,35,36,37,32,33,34,35,36,37,32,33,34,35,36,31,0,0,0,0,0,0,0,0,
0,0,0,0,0,0,0,0,1,25,26,27,22,23,24,25,26,27,22,23,24,25,26,1,0,0,0,0,0,0,0,0,
9,42,43,9,41,42,9,44,28,35,36,37,32,33,34,35,36,37,32,33,34,35,36,28,42,9,44,41,9,43,44,9,
19,52,53,19,51,52,19,54,38,25,26,27,22,23,24,25,26,27,22,23,24,25,26,38,52,19,54,51,19,53,54,19,
32,33,34,35,36,37,32,33,48,35,36,37,32,33,34,35,36,37,32,33,34,35,36,48,32,33,34,35,36,37,32,33,
22,23,24,25,26,27,22,23,58,25,26,27,22,23,24,25,26,27,22,23,24,25,26,58,22,23,24,25,26,27,22,23,
32,33,34,35,36,37,32,33,34,35,36,37,32,33,34,35,36,37,32,33,34,35,36,37,32,33,34,35,36,37,32,33,
22,23,24,25,26,27,22,23,24,25,26,27,22,23,24,25,26,27,22,23,24,25,26,27,22,23,24,25,26,27,22,23,
32,33,34,35,36,37,32,33,8,35,36,37,32,33,34,35,36,37,32,33,34,35,36,8,32,33,34,35,36,37,32,33,
10,23,24,10,26,27,10,23,18,25,26,27,22,23,24,25,26,27,22,23,24,25,26,18,22,10,24,25,10,27,22,10,
41,42,43,44,41,42,43,44,1,35,36,37,32,33,34,35,36,37,32,33,34,35,36,1,42,43,44,41,42,43,44,41,
51,52,53,54,51,52,53,54,11,25,26,27,22,23,24,25,26,27,22,23,24,25,26,11,52,53,54,51,52,53,54,51,
0,0,0,0,0,0,0,0,21,35,36,37,32,33,34,35,36,37,32,33,34,35,36,21,0,0,0,0,0,0,0,0,
0,0,0,0,0,0,0,0,31,25,26,27,22,23,24,25,26,27,22,23,24,25,26,31,0,0,0,0,0,0,0,0,
0,0,0,0,0,0,0,0,1,35,36,37,32,33,34,35,36,37,32,33,34,35,36,1,0,0,0,0,0,0,0,0,
0,0,0,0,0,0,0,0,11,25,26,27,22,23,24,25,26,27,22,23,24,25,26,11,0,0,0,0,0,0,0,0,
0,0,0,0,0,0,0,0,21,35,36,37,32,33,34,35,36,37,32,33,34,35,36,21,0,0,0,0,0,0,0,0,
0,0,0,0,0,0,0,0,31,25,26,27,22,23,24,25,26,27,22,23,24,25,26,31,0,0,0,0,0,0,0,0,
0,0,0,0,0,0,0,0,1,35,36,10,32,33,10,35,36,10,32,33,10,35,36,1,0,0,0,0,0,0,0,0,
0,0,0,0,0,0,0,0,41,42,43,44,41,42,43,44,41,42,43,44,41,42,43,44,0,0,0,0,0,0,0,0,
0,0,0,0,0,0,0,0,51,52,53,54,51,52,53,54,51,52,53,54,51,52,53,54,0,0,0,0,0,0,0,0,
0,0,0,0,0,0,0,0,0,0,0,0,0,0,0,0,0,0,0,0,0,0,0,0,0,0,0,0,0,0,0,0,
0,0,0,0,0,0,0,0,0,0,0,0,0,0,0,0,0,0,0,0,0,0,0,0,0,0,0,0,0,0,0,0