0,0,0,0,0,0,0,0,0,0,0,0,0,1,26,27,22,23,24,1,0,0,0,0,0,0,0,0,0,0,0,0,
0,0,0,0,0,0,0,0,0,0,0,0,0,11,36,37,32,33,34,11,0,0,0,0,0,0,0,0,0,0,0,0,
0,0,0,0,0,0,0,0,0,0,0,0,0,21,26,27,22,23,24,21,0,0,0,0,0,0,0,0,0,0,0,0,
0,0,0,1,2,3,9,2,3,9,2,3,9,2,3,37,32,33,2,9,4,2,9,4,2,9,4,2,1,0,0,0,
0,0,0,11,12,13,19,12,13,19,12,13,19,12,13,27,22,23,12,19,14,12,19,14,12,19,14,12,11,0,0,0,
0,0,0,21,32,33,34,35,36,37,32,33,34,35,36,37,32,33,34,35,36,37,32,33,34,35,36,37,21,0,0,0,
0,0,0,31,22,23,24,25,26,27,22,23,24,25,26,27,22,23,24,25,26,27,22,23,24,25,26,27,31,0,0,0,
0,0,0,1,32,33,34,35,36,37,32,33,34,35,36,37,32,33,34,35,36,37,32,33,34,35,36,37,1,0,0,0,
0,0,0,11,22,23,24,25,26,27,22,23,24,25,26,27,22,23,24,25,26,27,22,23,24,25,26,27,11,0,0,0,
0,0,0,21,32,33,34,35,36,37,32,33,34,35,36,37,32,33,34,35,36,37,32,33,34,35,36,37,21,0,0,0,
0,0,0,31,22,23,24,25,26,27,22,23,24,25,26,27,22,23,24,25,26,27,22,23,24,25,26,27,31,0,0,0,
0,0,0,1,32,33,34,35,36,37,32,33,34,35,36,37,32,33,34,35,36,37,32,33,34,35,36,37,1,0,0,0,
0,0,0,11,22,23,24,25,26,27,22,23,24,25,26,27,22,23,24,25,26,27,22,23,24,25,26,27,11,0,0,0,
0,0,0,21,32,33,34,35,36,37,32,33,34,35,36,37,32,33,34,35,36,37,32,33,34,35,36,37,21,0,0,0,
0,0,0,31,22,23,24,25,26,27,22,23,24,25,26,27,22,23,24,25,26,27,22,23,24,25,26,27,31,0,0,0,
0,0,0,1,32,33,34,35,36,37,32,33,34,35,36,37,32,33,34,35,36,37,32,33,34,35,36,37,1,0,0,0,
0,0,0,11,22,23,24,25,26,27,22,23,24,25,26,27,22,23,24,25,26,27,22,23,24,25,26,27,11,0,0,0,
0,0,0,21,32,33,34,35,36,37,32,33,34,35,36,37,32,33,34,35,36,37,32,33,34,35,36,37,21,0,0,0,
0,0,0,31,22,23,24,25,26,27,22,23,24,25,26,27,22,23,24,25,26,27,22,23,24,25,26,27,31,0,0,0,
0,0,0,1,32,33,34,35,36,37,32,33,34,35,36,37,32,33,34,35,36,37,32,33,34,35,36,37,1,0,0,0,
0,0,0,11,22,23,24,25,26,27,22,23,24,25,26,27,22,23,24,25,26,27,22,23,24,25,26,27,11,0,0,0,
0,0,0,21,32,33,34,35,36,37,32,33,34,35,36,37,32,33,34,35,36,37,32,33,34,35,36,37,21,0,0,0,
0,0,0,31,22,23,24,25,26,27,22,23,24,25,26,27,22,23,24,25,26,27,22,23,24,25,26,27,31,0,0,0,
0,0,0,1,32,33,34,35,36,37,32,33,34,35,36,37,32,33,34,35,36,37,32,33,34,35,36,37,1,0,0,0,
0,0,0,11,22,23,24,25,26,27,22,23,24,25,26,27,22,23,24,25,26,27,22,23,24,25,26,27,11,0,0,0,
0,0,0,21,32,33,34,35,36,37,32,33,34,35,36,37,32,33,34,35,36,37,32,33,34,35,36,37,21,0,0,0,
0,0,0,31,22,23,10,25,26,10,22,23,10,25,26,27,22,23,24,10,26,27,10,23,24,10,26,27,31,0,0,0,
0,0,0,2,3,4,2,3,4,2,3,4,2,21,4,37,32,33,2,21,4,2,3,4,2,3,4,2,3,0,0,0,
0,0,0,12,13,14,12,13,14,12,13,14,12,31,14,27,22,23,12,31,14,12,13,14,12,13,14,12,13,0,0,0,
0,0,0,0,0,0,0,0,0,0,0,0,0,11,36,37,32,33,34,11,0,0,0,0,0,0,0,0,0,0,0,0,
0,0,0,0,0,0,0,0,0,0,0,0,0,21,26,27,22,23,24,21,0,0,0,0,0,0,0,0,0,0,0,0,
0,0,0,0,0,0,0,0,0,0,0,0,0,31,36,37,32,33,34,31,0,0,0,0,0,0,0,0,0,0,0,0
