0,0,0,0,0,0,0,0,0,0,0,0,1,25,26,27,22,23,24,1,0,0,0,0,0,0,0,0,0,0,0,0,
0,0,0,0,0,0,0,0,0,0,0,0,11,35,36,37,32,33,34,11,0,0,0,0,0,0,0,0,0,0,0,0,
0,0,0,0,0,0,0,0,0,0,0,0,21,25,26,27,22,23,24,21,0,0,0,0,0,0,0,0,0,0,0,0,
0,0,0,0,0,0,0,0,0,0,0,0,1,35,36,37,32,33,34,1,0,0,0,0,0,0,0,0,0,0,0,0,
0,0,0,0,0,0,0,0,0,0,0,0,11,25,26,27,22,23,24,11,0,0,0,0,0,0,0,0,0,0,0,0,
0,0,0,0,0,0,0,0,0,0,0,0,21,35,36,37,32,33,34,21,0,0,0,0,0,0,0,0,0,0,0,0,
0,0,0,0,0,0,0,0,0,0,0,0,31,25,26,27,22,23,24,31,0,0,0,0,0,0,0,0,0,0,0,0,
0,0,0,1,42,43,9,41,42,9,44,41,9,2,3,37,32,2,3,9,41,42,9,44,41,9,43,44,1,0,0,0,
0,0,0,11,52,53,19,51,52,19,54,51,19,12,13,27,22,12,13,19,51,52,19,54,51,19,53,54,11,0,0,0,
0,0,0,21,32,33,34,35,36,37,32,33,34,35,36,37,32,33,34,35,36,37,32,33,34,35,36,37,21,0,0,0,
0,0,0,31,22,23,24,25,26,27,22,23,24,25,26,27,22,23,24,25,26,27,22,23,24,25,26,27,31,0,0,0,
0,0,0,1,32,33,34,35,36,37,32,33,34,35,36,37,32,33,34,35,36,37,32,33,34,35,36,37,1,0,0,0,
0,0,0,11,22,23,24,25,26,27,22,23,24,25,26,27,22,23,24,25,26,27,22,23,24,25,26,27,11,0,0,0,
0,0,0,21,32,33,34,35,36,37,32,33,34,35,36,37,32,33,34,35,36,37,32,33,34,35,36,37,21,0,0,0,
0,0,0,31,22,23,24,25,26,27,22,23,24,25,26,27,22,23,24,25,26,27,22,23,24,25,26,27,31,0,0,0,
0,0,0,1,32,33,34,35,36,37,32,33,34,35,36,37,32,33,34,35,36,37,32,33,34,35,36,37,1,0,0,0,
0,0,0,11,22,23,24,25,26,27,22,23,24,25,26,27,22,23,24,25,26,27,22,23,24,25,26,27,11,0,0,0,
0,0,0,21,32,33,34,35,36,37,32,33,34,35,36,37,32,33,34,35,36,37,32,33,34,35,36,37,21,0,0,0,
0,0,0,31,22,23,24,25,26,27,22,23,24,25,26,27,22,23,24,25,26,27,22,23,24,25,26,27,31,0,0,0,
0,0,0,1,32,33,34,35,36,37,32,33,34,35,36,37,32,33,34,35,36,37,32,33,34,35,36,37,1,0,0,0,
0,0,0,11,22,23,24,25,26,27,22,23,24,25,26,27,22,23,24,25,26,27,22,23,24,25,26,27,11,0,0,0,
0,0,0,21,32,33,34,35,36,37,32,33,34,35,36,37,32,33,34,35,36,37,32,33,34,35,36,37,21,0,0,0,
0,0,0,31,22,23,10,25,26,10,22,23,10,25,26,27,22,23,24,10,26,27,10,23,24,10,26,27,31,0,0,0,
0,0,0,41,42,43,44,41,42,43,44,41,21,2,3,37,32,2,3,21,41,42,43,44,41,42,43,44,41,0,0,0,
0,0,0,51,52,53,54,51,52,53,54,51,31,12,13,27,22,12,13,31,51,52,53,54,51,52,53,54,51,0,0,0,
0,0,0,0,0,0,0,0,0,0,0,0,1,35,36,37,32,33,34,1,0,0,0,0,0,0,0,0,0,0,0,0,
0,0,0,0,0,0,0,0,0,0,0,0,11,25,26,27,22,23,24,11,0,0,0,0,0,0,0,0,0,0,0,0,
0,0,0,0,0,0,0,0,0,0,0,0,21,35,36,37,32,33,34,21,0,0,0,0,0,0,0,0,0,0,0,0,
0,0,0,0,0,0,0,0,0,0,0,0,1,25,26,27,22,23,24,1,0,0,0,0,0,0,0,0,0,0,0,0,
0,0,0,0,0,0,0,0,0,0,0,0,11,35,36,37,32,33,34,11,0,0,0,0,0,0,0,0,0,0,0,0,
0,0,0,0,0,0,0,0,0,0,0,0,21,25,26,27,22,23,24,21,0,0,0,0,0,0,0,0,0,0,0,0,
0,0,0,0,0,0,0,0,0,0,0,0,31,35,36,37,32,33,34,31,0,0,0,0,0,0,0,0,0,0,0,0
